13 14
#######E######
#...#.....#..#
#.###.#.#.##.#
#.#...#.#....#
#.#.#.########
#.#.#........#
#.#.###.####.#
#.#.....#.#..#
#.#####.#.#.##
#...#...#.#..#
##..#.###.##.#
#..B...#..A..#
##############
